1 11 11 11 11 11 11 11 11 11 11 1 1 1 1 1 1 1 1 1 1 1 1 1 11 11 11 11 11 11 11 11 11 11 11 11 11 11 11 12
8 4 4 4 6 4 4 4 6 4 4 9 1 1 1 1 1 1 1 1 1 1 1 8 4 4 4 6 4 4 4 4 6 4 4 4 6 4 4 9
8 5 5 5 7 5 5 5 7 5 5 9 1 1 1 1 1 1 1 1 1 1 1 8 5 5 5 7 5 5 5 5 7 5 5 5 7 5 5 9
8 0 0 0 0 0 0 0 0 0 0 11 11 11 11 11 11 11 11 11 11 11 11 11 0 0 0 0 0 0 0 0 0 0 0 0 0 0 0 9
8 0 0 0 0 0 0 0 0 0 0 4 4 4 6 4 4 4 4 6 4 4 4 4 0 0 0 0 0 0 0 0 0 0 0 0 0 0 0 9
8 0 0 0 0 0 0 0 0 0 0 5 5 5 7 5 5 5 5 7 5 5 5 5 0 0 0 0 0 0 0 0 0 3 0 0 0 0 0 9
8 0 0 0 0 0 0 0 0 0 0 0 0 0 0 0 0 0 0 0 0 0 0 0 0 0 0 0 0 0 0 0 0 0 0 0 0 0 0 9
8 0 0 0 0 0 0 0 0 0 0 0 0 0 0 0 0 0 0 0 0 0 0 0 0 0 0 0 0 0 0 0 0 0 0 0 0 0 0 9
8 0 0 0 0 0 0 0 0 0 0 10 10 10 10 10 10 10 10 10 10 10 10 10 0 0 0 0 0 0 0 0 0 0 0 0 0 0 0 9
8 0 0 0 0 0 0 0 0 0 0 9 1 1 1 1 1 1 1 1 1 1 1 8 0 0 0 0 0 0 0 0 0 0 0 0 0 0 0 9
8 0 0 0 0 0 0 0 0 0 0 9 1 1 1 1 1 1 1 1 1 1 1 8 0 0 0 0 0 0 0 0 0 0 0 0 0 0 0 9
1 10 10 10 0 0 0 0 10 10 10 1 1 1 1 1 1 1 1 1 1 1 1 8 0 0 0 0 0 0 0 0 0 0 0 0 0 0 0 9
1 1 1 8 0 0 0 0 9 1 1 1 1 1 1 1 1 1 11 11 11 11 11 11 0 0 0 0 0 0 0 0 0 0 0 0 0 0 0 9
1 1 1 8 0 0 0 0 9 1 1 1 1 1 1 1 1 8 4 4 4 4 6 4 0 0 0 0 0 0 0 0 0 0 0 0 0 0 0 9
1 1 1 8 0 0 0 0 9 1 1 1 1 1 1 1 1 8 5 5 5 5 7 5 0 0 0 0 0 0 0 0 0 0 0 0 0 0 0 9
1 1 1 8 0 0 0 0 9 1 1 1 1 1 1 1 1 8 0 0 0 0 0 0 0 0 0 0 0 0 0 0 0 0 0 0 0 0 0 9
1 1 1 8 0 0 0 0 9 1 1 1 1 1 1 1 1 8 0 0 0 0 0 0 0 0 0 0 0 0 0 0 0 0 0 0 0 0 0 9
1 1 1 8 0 0 0 0 9 1 1 1 1 1 1 1 1 8 0 0 0 0 0 0 0 0 0 0 0 0 0 0 0 0 0 0 0 0 0 9
1 11 11 11 0 0 0 0 11 11 11 11 11 11 11 11 11 11 0 0 0 0 0 0 0 0 0 0 0 0 0 0 0 0 0 0 0 0 0 9
8 4 4 4 0 0 0 0 4 4 6 4 4 4 4 6 4 4 0 0 0 0 0 0 0 0 0 0 0 0 0 0 0 0 0 0 0 0 0 9
8 5 5 5 0 0 0 0 5 5 7 5 5 5 5 7 5 5 0 0 0 0 0 0 0 0 0 0 0 0 0 0 0 0 0 0 0 0 0 9
8 0 0 0 0 0 0 0 0 0 0 0 0 0 0 0 0 0 0 0 0 0 0 0 0 0 0 0 0 0 0 0 0 0 0 0 0 0 0 9
8 0 0 0 0 0 0 0 0 0 0 0 0 0 0 0 0 0 0 0 0 0 0 0 0 0 0 0 0 0 0 0 0 0 0 0 0 0 0 9
8 0 0 0 0 0 0 0 0 0 0 0 0 0 0 0 0 0 0 0 0 0 0 0 0 0 0 0 0 0 0 0 0 0 0 0 0 0 0 9
8 0 0 0 0 0 0 0 0 0 0 0 0 0 10 10 10 10 10 10 10 10 10 10 10 10 10 10 10 0 0 0 0 0 0 0 0 0 0 9
8 0 0 0 0 0 0 0 0 0 0 0 0 0 9 1 1 1 1 1 1 1 1 1 1 1 1 1 8 0 0 0 0 0 0 0 0 0 0 9
8 0 0 0 0 0 0 0 0 0 0 0 0 0 9 1 1 1 1 1 1 1 1 1 1 1 1 1 8 0 0 0 0 0 0 0 0 0 0 9
8 0 0 0 0 0 0 0 0 0 0 0 0 0 9 1 1 1 1 1 1 1 1 1 1 1 1 1 8 0 0 0 0 0 0 0 0 0 0 9
8 0 0 0 0 0 0 0 0 0 0 0 0 0 9 1 1 1 1 1 1 1 1 1 1 1 1 1 8 0 0 0 0 0 0 0 0 0 0 9
1 10 10 10 10 10 10 10 10 10 10 10 10 10 1 1 1 1 1 1 1 1 1 1 1 1 1 1 1 10 10 10 10 10 10 10 10 10 10 13
